{"template":{"id": 1,
			"teamsize": 1,
			"name":"template",
			"grid":[["OOO","OOO","OOO","OOO","OOO","OOO","OOO","OOO","OOO","OOO","OOO","OOO","OOO","OOO","OOO","OOO","OOO","OOO","OOO","OOO","OOO","OOO","OOO","OOO","OOO"],
					["OOO","col","but","...","...","...","...","tod","fur","cut","mor","enc","OOO","...","...","...","...","...","...","...","...","...","...","...","OOO"],
					["OOO","...","...","...","...","...","...","...","...","...","...","...","OOO","...","...","...","...","...","...","...","...","...","...","...","OOO"],
					["OOO","...","...",".1.","...","...","...","...","...","...","...","...","OOO","...","...","...","...","...","...","...","...","...","...","...","OOO"],
					["OOO","...","...","...","...","...","...","...","...","...","...","...",".D.","...","...","...","...","...","...","...","...","...","...","...","OOO"],
					["OOO","...","...","...","...","...","...","...","...","...","...","...","OOO","...","...","...","...","...","...","...","...","...","...","...","OOO"],
					["OOO","...","...","...","...","...","...","...","...","...","...","...","OOO","...","...","...","...","...","...","...","...","...","...","...","OOO"],
					["OOO","...","...","...","...","...","...","...","...","...","...","...","OOO","...","...","...","...","...","...","...","...","...","...","...","OOO"],
					["OOO","OOO","OOO","OOO","OOO","OOO",".D.","OOO","OOO","OOO","OOO","OOO","OOO","OOO","OOO","OOO","OOO","OOO",".D.","OOO","OOO","OOO","OOO","OOO","OOO"],
					["OOO","...","...","...","...","...","...","...","...","...","...","...","OOO","...","...","...","...","...","...","...","...","...","...","...","OOO"],
					["OOO","...","...","...","...","...","...","...","...","...","...","...","OOO","...","...","...","...","...","...","...","...","...","...","...","OOO"],
					["OOO","...","...","...","...","...","...","...","...","...","...","...","OOO","...","...","...","...","...","...","...","...","...","...","...","OOO"],
					["OOO","...","...","...","...","...","...","...","...","...","...","...",".D.","...","...","...","...","...","...","...","...","...","...","...","OOO"],
					["OOO","...","...","...","...","...","...","...","...","...","...","...","OOO","...","...","...","...","...","...","...","...","...","...","...","OOO"],
					["OOO","...","...","...","...","...","...","...","...","...","...","...","OOO","...","...","...","...","...","...","...","...","...","...","...","OOO"],
					["OOO","...","...","...","...","...","...","...","...","...","...","...","OOO","...","...","...","...","...","...","...","...","...","...","...","OOO"],
					["OOO","OOO","OOO","OOO","OOO","OOO","OOO","OOO","OOO","OOO","OOO","OOO","OOO","OOO","OOO","OOO","OOO","OOO","OOO","OOO","OOO","OOO","OOO","OOO","OOO"]
					]
			}
}