{
    "map1":{   
        "bkg":"sky3.png",
        "filter":"SHADOW",
        "effect":"SNOW",
        "lvls":3,
    
        "tileSize":64,
        "level":{
			     "0":{
                     "grid":[["XXX","XXX","XXX","XXX","XXX","XXX","XXX","XXX","XXX","XXX","XXX","XXX","XXX","XXX","XXX","XXX","XXX","XXX","XXX","XXX","XXX","XXX","XXX","XXX","XXX"],
                            ["XXX","___","___","___","___","___","___","___","___","___","___","___","___","___","___","___","___","___","___","___","___","___","___","___","XXX"],
                            ["XXX","___","___","___","___","___","___","___","___","___","___","___","___","___","___","___","___","___","___","___","___","___","___","___","XXX"],
                            ["XXX","___","___","___","___","___","___","___","___","___","___","___","___","___","___","___","___","___","___","___","___","___","___","___","XXX"],
                            ["XXX","___","___","___","___","___","___","___","___","___","___","___","___","___","___","___","___","___","___","___","___","___","___","___","XXX"],
                            ["XXX","___","_0_","_1_","_2_","___","___","___","___","___","___","___","___","___","___","___","___","_a_","_b_","_c_","___","___","___","___","XXX"],
                            ["XXX","___","_3_","_4_","_5_","___","___","___","___","___","___","___","___","___","___","___","___","_d_","_e_","_f_","___","___","___","___","XXX"],
                            ["XXX","___","_6_","_7_","_8_","___","___","___","___","___","___","___","___","___","___","___","___","___","___","___","___","___","___","___","XXX"],
                            ["XXX","___","___","___","___","___","___","___","___","___","___","___","___","___","___","___","___","___","___","___","___","___","___","___","XXX"],
                            ["XXX","___","___","___","___","___","___","___","___","___","___","___","___","___","___","___","___","___","___","___","___","___","___","___","XXX"],
                            ["XXX","___","___","___","___","___","___","___","___","___","___","___","___","___","___","___","___","___","___","___","___","___","___","___","XXX"],
                            ["XXX","___","___","___","___","___","___","___","___","___","___","___","___","___","___","___","___","___","___","___","___","___","___","___","XXX"],
                            ["XXX","___","___","___","___","___","___","___","___","___","___","___","___","___","___","___","___","___","___","___","___","___","___","___","XXX"],
                            ["XXX","___","___","___","___","___","___","___","___","___","___","___","___","___","___","___","___","___","___","___","___","___","___","___","XXX"],
                            ["XXX","___","___","___","___","___","___","___","___","___","___","___","___","___","___","___","___","___","___","___","___","___","___","___","XXX"],
                            ["XXX","___","___","___","___","___","___","___","___","___","___","___","___","___","___","___","___","___","___","___","___","___","___","___","XXX"],
                            ["XXX","XXX","XXX","XXX","XXX","XXX","XXX","XXX","XXX","XXX","XXX","XXX","XXX","XXX","XXX","XXX","XXX","XXX","XXX","XXX","XXX","XXX","XXX","XXX","XXX"]
                            ],
                     "entities":[]
                  },
                "1":{
                     "grid":[["XXX","XXX","XXX","XXX","XXX","XXX","XXX","XXX","XXX","XXX","XXX","XXX","XXX","XXX","XXX","XXX","XXX","XXX","XXX","XXX","XXX","XXX","XXX","XXX","XXX"],
                            ["XXX","   ","   ","   ","   ","   ","   ","   ","   ","   ","   ","   ","   ","   ","   ","   ","   ","   ","   ","   ","   ","   ","   ","   ","XXX"],
                            ["XXX","   ","   ","   ","   ","   ","   ","   ","   ","   ","   ","   ","   ","   ","   ","   ","   ","   ","   ","   ","   ","   ","   ","   ","XXX"],
                            ["XXX","   ","   ","   ","   ","   ","   ","   ","   ","   ","   ","   ","   ","   ","   ","   ","   ","   ","   ","   ","   ","   ","   ","   ","XXX"],
                            ["XXX","   ","   ","   ","   ","   ","   ","   ","   ","   ","   ","   ","   ","   ","   ","   ","   ","   ","   ","   ","   ","   ","   ","   ","XXX"],
                            ["XXX","   ","   ","   ","   ","   ","   ","   ","   ","   ","   ","   ","   ","   ","   ","   ","   ","   ","   ","   ","   ","   ","   ","   ","XXX"],
                            ["XXX","   ","   ","   ","   ","   ","   ","   ","   ","   ","   ","   ","   ","   ","   ","   ","   ","   ","   ","   ","   ","   ","   ","   ","XXX"],
                            ["XXX","   ","   ","   ","   ","   ","   ","   ","   ","   ","   ","   ","   ","   ","   ","   ","   ","   ","   ","   ","   ","   ","   ","   ","XXX"],
                            ["XXX","   ","   ","   ","   ","   ","   ","   ","   ","   ","   ","   ","   ","   ","   ","   ","   ","   ","   ","   ","   ","   ","   ","   ","XXX"],
                            ["XXX","   ","   ","   ","   ","   ","   ","   ","   ","   ","   ","   ","   ","   ","   ","   ","   ","   ","   ","   ","   ","   ","   ","   ","XXX"],
                            ["XXX","   ","   ","   ","   ","   ","   ","   ","   ","   ","   ","   ","   ","   ","   ","   ","   ","   ","   ","   ","   ","   ","   ","   ","XXX"],
                            ["XXX","   ","   ","   ","   ","   ","   ","   ","   ","   ","   ","   ","   ","   ","   ","   ","   ","   ","   ","   ","   ","   ","   ","   ","XXX"],
                            ["XXX","   ","   ","   ","   ","   ","   ","   ","   ","   ","   ","   ","   ","   ","   ","   ","   ","   ","   ","   ","   ","   ","   ","   ","XXX"],
                            ["XXX","   ","   ","   ","   ","   ","   ","   ","   ","   ","   ","   ","   ","   ","   ","   ","   ","   ","   ","   ","   ","   ","   ","   ","XXX"],
                            ["XXX","   ","   ","   ","   ","   ","   ","   ","   ","   ","   ","   ","   ","   ","   ","   ","   ","   ","   ","   ","   ","   ","   ","   ","XXX"],
                            ["XXX","   ","   ","   ","   ","   ","   ","   ","   ","   ","   ","   ","   ","   ","   ","   ","   ","   ","   ","   ","   ","   ","   ","   ","XXX"],
                            ["XXX","XXX","XXX","XXX","XXX","XXX","XXX","XXX","XXX","XXX","XXX","XXX","XXX","XXX","XXX","XXX","XXX","XXX","XXX","XXX","XXX","XXX","XXX","XXX","XXX"]
                            ],

                     "entities":[]
                  },  
                "2":{
                     "grid":[["XXX","XXX","XXX","XXX","XXX","XXX","XXX","XXX","XXX","XXX","XXX","XXX","XXX","XXX","XXX","XXX","XXX","XXX","XXX","XXX","XXX","XXX","XXX","XXX","XXX"],
                            ["XXX","^^^","^^^","^^^","^^^","^^^","^^^","^^^","^^^","^^^","^^^","^^^","^^^","^^^","^^^","^^^","^^^","^^^","^^^","^^^","^^^","   ","   ","   ","XXX"],
                            ["XXX","^^^","^^^","^^^","^^^","^^^","^^^","^^^","^^^","^^^","^^^","^^^","^^^","^^^","^^^","^^^","^^^","^^^","^^^","^^^","^^^","   ","   ","   ","XXX"],
                            ["XXX","^^^","^^^","^^^","^^^","^^^","^^^","^^^","^^^","^^^","^^^","^^^","^^^","^^^","^^^","^^^","^^^","^^^","^^^","^^^","^^^","   ","   ","   ","XXX"],
                            ["XXX","^^^","^^^","^^^","^^^","^^^","^^^","^^^","^^^","^^^","^^^","^^^","^^^","^^^","^^^","^^^","^^^","^^^","^^^","^^^","^^^","   ","   ","   ","XXX"],
                            ["XXX","^^^","^^^","^^^","^^^","^^^","^^^","^^^","^^^","^^^","^^^","^^^","^^^","^^^","^^^","^^^","^^^","^^^","^^^","^^^","^^^","   ","   ","   ","XXX"],
                            ["XXX","^^^","^^^","^^^","^^^","^^^","^^^","^^^","^^^","^^^","^^^","^^^","^^^","^^^","^^^","^^^","^^^","^^^","^^^","^^^","^^^","   ","   ","   ","XXX"],
                            ["XXX","^^^","^^^","^^^","^^^","^^^","^^^","^^^","^^^","^^^","^^^","^^^","^^^","^^^","^^^","^^^","^^^","^^^","^^^","^^^","^^^","   ","   ","   ","XXX"],
                            ["XXX","^^^","^^^","^^^","^^^","^^^","^^^","^^^","^^^","^^^","^^^","^^^","^^^","^^^","^^^","^^^","^^^","^^^","^^^","^^^","^^^","   ","   ","   ","XXX"],
                            ["XXX","^^^","^^^","^^^","^^^","^^^","^^^","^^^","^^^","^^^","^^^","^^^","^^^","^^^","^^^","^^^","^^^","^^^","^^^","^^^","^^^","   ","   ","   ","XXX"],
                            ["XXX","^^^","^^^","^^^","^^^","^^^","^^^","^^^","^^^","^^^","^^^","^^^","^^^","^^^","^^^","^^^","^^^","^^^","^^^","^^^","^^^","   ","   ","   ","XXX"],
                            ["XXX","^^^","^^^","^^^","^^^","^^^","^^^","^^^","^^^","^^^","^^^","^^^","^^^","^^^","^^^","^^^","^^^","^^^","^^^","^^^","^^^","   ","   ","   ","XXX"],
                            ["XXX","^^^","^^^","^^^","^^^","^^^","^^^","^^^","^^^","^^^","^^^","^^^","^^^","^^^","^^^","^^^","^^^","^^^","^^^","^^^","^^^","   ","   ","   ","XXX"],
                            ["XXX","^^^","^^^","^^^","^^^","^^^","^^^","^^^","^^^","^^^","^^^","^^^","^^^","^^^","^^^","^^^","^^^","^^^","^^^","^^^","^^^","   ","   ","   ","XXX"],
                            ["XXX","^^^","^^^","^^^","^^^","^^^","^^^","^^^","^^^","^^^","^^^","^^^","^^^","^^^","^^^","^^^","^^^","^^^","^^^","^^^","^^^","   ","   ","   ","XXX"],
                            ["XXX","^^^","^^^","^^^","^^^","^^^","^^^","^^^","^^^","^^^","^^^","^^^","^^^","^^^","^^^","^^^","^^^","^^^","^^^","^^^","^^^","   ","   ","   ","XXX"],
                            ["XXX","XXX","XXX","XXX","XXX","XXX","XXX","XXX","XXX","XXX","XXX","XXX","XXX","XXX","XXX","XXX","XXX","XXX","XXX","XXX","XXX","XXX","XXX","XXX","XXX"]
                            ],
                     "entities":[]
                  }

            }
        }
 
 
 
}